自用拼音	中古拼音(polyhedron 版)
pǔŋ	pungx
pu̍k	puk
phu̍k	phuk
būŋ	bung
bǔŋ	bungx
bu̍k	buk
mūŋ	mung
mǔŋ	mungx
mùŋ	mungh
mu̍k	muk
tūŋ	tung
tǔŋ	tungx
tùŋ	tungh
tu̍k	tuk
thūŋ	thung
thǔŋ	thungx
thùŋ	thungh
thu̍k	thuk
dūŋ	dung
dǔŋ	dungx
dùŋ	dungh
du̍k	duk
nǔŋ	nungx
nùŋ	nungh
lūŋ	lung
lǔŋ	lungx
lùŋ	lungh
lu̍k	luk
tsūŋ	cung
tsǔŋ	cungx
tsùŋ	cungh
tsu̍k	cuk
tshūŋ	chung
tshùŋ	chungh
tshu̍k	chuk
dzūŋ	zung
dzùŋ	zungh
dzu̍k	zuk
sūŋ	sung
sǔŋ	sungx
sùŋ	sungh
su̍k	suk
kūŋ	kung
kùŋ	kungh
ku̍k	kuk
khūŋ	khung
khǔŋ	khungx
khùŋ	khungh
khu̍k	khuk
ŋūŋ	ngung
hūŋ	hung
hǔŋ	hungx
hùŋ	hungh
hu̍k	huk
ĥūŋ	ghung
ĥǔŋ	ghungx
ĥùŋ	ghungh
ĥu̍k	ghuk
ȝūŋ	qung
ȝǔŋ	qungx
ȝùŋ	qungh
ȝu̍k	quk
liūŋ	liung
liu̍k	liuk
ṭiūŋ	triung
ṭiùŋ	triungh
ṭiu̍k	triuk
ṭhiūŋ	thriung
ṭhiu̍k	thriuk
ḍiūŋ	driung
ḍiùŋ	driungh
ḍiu̍k	driuk
ṇiu̍k	nriuk
tsiu̍k	ciuk
tshiùŋ	chiungh
tshiu̍k	chiuk
dziu̍k	ziuk
siūŋ	siung
siu̍k	siuk
tšiu̍k	criuk
tšhiu̍k	chriuk
džiūŋ	zriung
džiùŋ	zriungh
šiu̍k	sriuk
tśiūŋ	cjung
tśiùŋ	cjungh
tśiu̍k	cjuk
tśhiūŋ	chjung
tśhiùŋ	chjungh
tśhiu̍k	chjuk
dźiu̍k	zjuk
ńiūŋ	njung
ńiu̍k	njuk
śiu̍k	sjuk
kiūŋ	kiung
kiu̍k	kiuk
khiūŋ	khiung
khiùŋ	khiungh
khiu̍k	khiuk
giūŋ	giung
giu̍k	giuk
ŋiu̍k	ngiuk
hiùŋ	hiungh
hiu̍k	hiuk
ȝiu̍k	qiuk
jiūŋ	jung
jiu̍k	juk
iūŋ	iung
iu̍k	iuk
püūŋ	piung
püùŋ	piungh
püu̍k	piuk
phüūŋ	phiung
phüùŋ	phiungh
phüu̍k	phiuk
büūŋ	biung
büùŋ	biungh
büu̍k	biuk
müūŋ	miung
müùŋ	miungh
müu̍k	miuk
po̍k	puuk
bo̍k	buuk
mǒŋ	muungx
mòŋ	muungh
mo̍k	muuk
tōŋ	tuung
tǒŋ	tuungx
to̍k	tuuk
thōŋ	thuung
thòŋ	thuungh
dōŋ	duung
do̍k	duuk
nōŋ	nuung
no̍k	nuuk
lōŋ	luung
lo̍k	luuk
tsōŋ	cuung
tsòŋ	cuungh
tso̍k	cuuk
dzōŋ	zuung
sōŋ	suung
sòŋ	suungh
so̍k	suuk
kōŋ	kuung
ko̍k	kuuk
kho̍k	khuuk
ŋo̍k	nguuk
ho̍k	huuk
ĥōŋ	ghuung
ĥòŋ	ghuungh
ĥo̍k	ghuuk
ȝo̍k	quuk
liōŋ	lyung
liǒŋ	lyungx
liòŋ	lyungh
lio̍k	lyuk
ṭiǒŋ	tryungx
ṭiòŋ	tryungh
ṭio̍k	tryuk
ṭhiōŋ	thryung
ṭhiǒŋ	thryungx
ṭhiòŋ	thryungh
ṭhio̍k	thryuk
ḍiōŋ	dryung
ḍiǒŋ	dryungx
ḍiòŋ	dryungh
ḍio̍k	dryuk
ṇiōŋ	nryung
ṇiòŋ	nryungh
tsiōŋ	cyung
tsiǒŋ	cyungx
tsiòŋ	cyungh
tsio̍k	cyuk
tshiōŋ	chyung
tshio̍k	chyuk
dziōŋ	zyung
dziòŋ	zyungh
siōŋ	syung
siǒŋ	syungx
sio̍k	syuk
ziōŋ	zsyung
ziòŋ	zsyungh
zio̍k	zsyuk
tśiōŋ	cjyung
tśiǒŋ	cjyungx
tśiòŋ	cjyungh
tśio̍k	cjyuk
tśhiōŋ	chjyung
tśhiǒŋ	chjyungx
tśhio̍k	chjyuk
dźiōŋ	zjyung
dźiǒŋ	zjyungx
dźio̍k	zjyuk
ńiōŋ	njyung
ńiǒŋ	njyungx
ńiòŋ	njyungh
ńio̍k	njyuk
śiōŋ	sjyung
śio̍k	sjyuk
źio̍k	zsjyuk
kiōŋ	kyung
kiǒŋ	kyungx
kiòŋ	kyungh
kio̍k	kyuk
khiōŋ	khyung
khiǒŋ	khyungx
khiòŋ	khyungh
khio̍k	khyuk
giōŋ	gyung
giǒŋ	gyungx
giòŋ	gyungh
gio̍k	gyuk
ŋiōŋ	ngyung
ŋio̍k	ngyuk
hiōŋ	hyung
hiǒŋ	hyungx
hio̍k	hyuk
ȝiōŋ	qyung
ȝiǒŋ	qyungx
ȝiòŋ	qyungh
jiōŋ	jyung
jiǒŋ	jyungx
jiòŋ	jyungh
jio̍k	jyuk
püōŋ	pyung
püǒŋ	pyungx
püòŋ	pyungh
püo̍k	pyuk
phüōŋ	phyung
phüǒŋ	phyungx
büōŋ	byung
büǒŋ	byungx
büòŋ	byungh
büo̍k	byuk
pəōŋ	prung
pəǒŋ	prungx
pəo̍k	pruk
phəōŋ	phrung
phəòŋ	phrungh
phəo̍k	phruk
bəōŋ	brung
bəǒŋ	brungx
bəo̍k	bruk
məōŋ	mrung
məǒŋ	mrungx
məo̍k	mruk
ləōŋ	lrung
ləo̍k	lruk
ṭəōŋ	trung
ṭəòŋ	trungh
ṭəo̍k	truk
ṭhəōŋ	thrung
ṭhəòŋ	thrungh
ṭhəo̍k	thruk
ḍəōŋ	drung
ḍəòŋ	drungh
ḍəo̍k	druk
ṇəōŋ	nrung
ṇəo̍k	nruk
tšəo̍k	cruk
tšhəōŋ	chrung
tšhəòŋ	chrungh
tšhəo̍k	chruk
džəōŋ	zrung
džəòŋ	zrungh
džəo̍k	zruk
šəōŋ	srung
šəòŋ	srungh
šəo̍k	sruk
kəōŋ	krung
kəǒŋ	krungx
kəòŋ	krungh
kəo̍k	kruk
khəōŋ	khrung
khəo̍k	khruk
ŋəōŋ	ngrung
ŋəo̍k	ngruk
həōŋ	hrung
həǒŋ	hrungx
həo̍k	hruk
ĥəōŋ	ghrung
ĥəǒŋ	ghrungx
ĥəòŋ	ghrungh
ĥəo̍k	ghruk
ȝəōŋ	qrung
ȝəǒŋ	qrungx
ȝəo̍k	qruk
pьiē	pje
pьiě	pjex
pьiè	pjeh
phьiē	phje
phьiě	phjex
phьiè	phjeh
bьiē	bje
bьiě	bjex
bьiè	bjeh
mьiē	mje
mьiě	mjex
lьiē	lie
lьiě	liex
lьiè	lieh
tsьiē	cie
tsьiě	ciex
tsьiè	cieh
tshьiē	chie
tshьiě	chiex
tshьiè	chieh
dzьiē	zie
dzьiè	zieh
sьiē	sie
sьiě	siex
sьiè	sieh
tśьiē	cje
tśьiě	cjex
tśьiè	cjeh
tśhьiē	chje
tśhьiě	chjex
tśhьiè	chjeh
dźьiē	zje
dźьiě	zjex
dźьiè	zjeh
ńьiē	nje
ńьiě	njex
śьiē	sje
śьiě	sjex
śьiè	sjeh
źьiě	zsjex
kьiě	kjex
kьiè	kjeh
khьiě	khjex
khьiè	khjeh
gьiē	gje
hьiē	hje
ȝьiè	qjeh
jьiē	je
jьiě	jex
jьiè	jeh
lьüē	lye
lьüě	lyex
lьüè	lyeh
tsьüē	cye
tsьüě	cyex
dzьüě	zyex
sьüē	sye
sьüě	syex
sьüè	syeh
zьüē	zsye
zьüě	zsyex
tśьüě	cjyex
tśьüè	cjyeh
tśhьüē	chjye
tśhьüè	chjyeh
dźьüē	zjye
dźьüě	zjyex
dźьüè	zjyeh
ńьüē	njye
ńьüě	njyex
ńьüè	njyeh
kьüē	kjye
kьüè	kjyeh
khьüē	khjye
khьüě	khjyex
khьüè	khjyeh
hьüē	hjye
hьüè	hjyeh
ȝьüè	qjyeh
jьüē	jye
jьüě	jyex
jьüè	jyeh
piē	pie
piě	piex
piè	pieh
phiē	phie
phiě	phiex
phiè	phieh
biē	bie
biě	biex
biè	bieh
miē	mie
miě	miex
ṭiē	trie
ṭiě	triex
ṭiè	trieh
ṭhiē	thrie
ṭhiě	thriex
ḍiē	drie
ḍiě	driex
ṇiě	nriex
tšiē	crie
tšiě	criex
tšiè	crieh
tšhiē	chrie
džiē	zrie
šiē	srie
šiě	sriex
šiè	srieh
kiē	kie
kiě	kiex
kiè	kieh
khiē	khie
khiě	khiex
khiè	khieh
giē	gie
giě	giex
giè	gieh
ŋiē	ngie
ŋiě	ngiex
ŋiè	ngieh
hiē	hie
hiě	hiex
hiè	hieh
ȝiē	qie
ȝiě	qiex
ȝiè	qieh
ṭüē	trye
ṭüè	tryeh
ḍüē	drye
ḍüè	dryeh
ṇüè	nryeh
tšhüē	chrye
tšhüě	chryex
šüē	srye
küē	kye
küě	kyex
küè	kyeh
khüē	khye
khüě	khyex
güě	gyex
ŋüē	ngye
ŋüě	ngyex
ŋüè	ngyeh
hüē	hye
hüě	hyex
hüè	hyeh
ȝüē	qye
ȝüě	qyex
ȝüè	qyeh
üē	ye
üě	yex
üè	yeh
pьǐ	pjiix
pьì	pjiih
phьī	phjii
phьì	phjiih
bьī	bjii
bьǐ	bjiix
bьì	bjiih
mьì	mjiih
dьì	diih
lьī	lii
lьǐ	liix
lьì	liih
tsьī	cii
tsьǐ	ciix
tsьì	ciih
tshьī	chii
tshьì	chiih
dzьī	zii
dzьì	ziih
sьī	sii
sьǐ	siix
sьì	siih
zьǐ	zsiix
tśьī	cjii
tśьǐ	cjiix
tśьì	cjiih
tśhьī	chjii
tśhьì	chjiih
dźьǐ	zjiix
dźьì	zjiih
ńьì	njiih
śьī	sjii
śьǐ	sjiix
śьì	sjiih
źьì	zsjiih
khьì	khjiih
gьī	gjii
hьī	hjii
ȝьī	qjii
jьī	jii
jьì	jiih
lьüī	lyi
lьüǐ	lyix
lьüì	lyih
tsьüī	cyi
tsьüǐ	cyix
tsьüì	cyih
tshьüǐ	chyix
tshьüì	chyih
dzьüǐ	zyix
dzьüì	zyih
sьüī	syi
sьüì	syih
zьüì	zsyih
tśьüī	cjyi
tśhьüī	chjyi
tśhьüì	chjyih
dźьüī	zjyi
ńьüī	njyi
ńьüǐ	njyix
śьüǐ	sjyix
śьüì	sjyih
kьüǐ	kjyix
kьüì	kjyih
gьüī	gjyi
gьüǐ	gjyix
gьüì	gjyih
hьüī	hjyi
hьüǐ	hjyix
hьüì	hjyih
jьüī	jyi
jьüǐ	jyix
jьüì	jyih
pī	pii
pǐ	piix
pì	piih
phī	phii
phǐ	phiix
phì	phiih
bī	bii
bǐ	biix
bì	biih
mī	mii
mǐ	miix
mì	miih
ṭī	trii
ṭǐ	triix
ṭì	triih
ṭhī	thrii
ṭhǐ	thriix
ṭhì	thriih
ḍī	drii
ḍǐ	driix
ḍì	driih
ṇī	nrii
ṇǐ	nriix
ṇì	nriih
šī	srii
kī	kii
kǐ	kiix
kì	kiih
khì	khiih
gǐ	giix
gì	giih
ŋī	ngii
ŋì	ngiih
hì	hiih
ȝǐ	qiix
ȝì	qiih
ṭüī	tryi
ṭüì	tryih
ḍüī	dryi
ḍüì	dryih
tšhüì	chryih
šüī	sryi
šüì	sryih
küī	kyi
küǐ	kyix
küì	kyih
khüī	khyi
khüǐ	khyix
khüì	khyih
güī	gyi
güǐ	gyix
güì	gyih
hüì	hyih
üī	yi
üǐ	yix
üì	yih
lə̄	li
lə̌	lix
lə̀	lih
ṭə̌	trix
ṭə̀	trih
ṭhə̄	thri
ṭhə̌	thrix
ṭhə̀	thrih
ḍə̄	dri
ḍə̌	drix
ḍə̀	drih
ṇə̌	nrix
tsə̄	ci
tsə̌	cix
tshə̀	chih
dzə̄	zi
dzə̀	zih
sə̄	si
sə̌	six
sə̀	sih
zə̄	zsi
zə̌	zsix
zə̀	zsih
tšə̄	cri
tšə̌	crix
tšə̀	crih
tšhə̄	chri
tšhə̌	chrix
tšhə̀	chrih
džə̄	zri
džə̌	zrix
džə̀	zrih
šə̌	srix
šə̀	srih
žə̄	zsri
žə̌	zsrix
tśə̄	cji
tśə̌	cjix
tśə̀	cjih
tśhə̄	chji
tśhə̌	chjix
tśhə̀	chjih
dźə̄	zji
dźə̌	zjix
dźə̀	zjih
ńə̄	nji
ńə̌	njix
ńə̀	njih
śə̄	sji
śə̌	sjix
śə̀	sjih
kə̄	ki
kə̌	kix
kə̀	kih
khə̄	khi
khə̌	khix
khə̀	khih
gə̄	gi
gə̀	gih
ŋə̄	ngi
ŋə̌	ngix
ŋə̀	ngih
hə̄	hi
hə̌	hix
hə̀	hih
ȝə̄	qi
ȝə̌	qix
ȝə̀	qih
jə̄	ji
jə̌	jix
jə̀	jih
ə̌	ix
kiə̄i	kioi
kiə̌i	kioix
kiə̀i	kioih
khiə̌i	khioix
khiə̀i	khioih
giə̄i	gioi
giə̀i	gioih
ŋiə̄i	ngioi
ŋiə̌i	ngioix
ŋiə̀i	ngioih
hiə̄i	hioi
hiə̌i	hioix
hiə̀i	hioih
ȝiə̄i	qioi
ȝiə̌i	qioix
ȝiə̀i	qioih
püə̄i	pyoi
püə̌i	pyoix
püə̀i	pyoih
phüə̄i	phyoi
phüə̌i	phyoix
phüə̀i	phyoih
büə̄i	byoi
büə̌i	byoix
büə̀i	byoih
müə̄i	myoi
müə̌i	myoix
müə̀i	myoih
küə̄i	kyoi
küə̌i	kyoix
küə̀i	kyoih
khüə̄i	khyoi
khüə̀i	khyoih
ŋüə̄i	ngyoi
ŋüə̀i	ngyoih
hüə̄i	hyoi
hüə̌i	hyoix
hüə̀i	hyoih
ȝüə̄i	qyoi
ȝüə̌i	qyoix
ȝüə̀i	qyoih
üə̄i	yoi
üə̌i	yoix
üə̀i	yoih
liə̄	lio
liə̌	liox
liə̀	lioh
ṭiə̄	trio
ṭiə̌	triox
ṭiə̀	trioh
ṭhiə̄	thrio
ṭhiə̌	thriox
ṭhiə̀	thrioh
ḍiə̄	drio
ḍiə̌	driox
ḍiə̀	drioh
ṇiə̄	nrio
ṇiə̌	nriox
ṇiə̀	nrioh
tsiə̄	cio
tsiə̌	ciox
tsiə̀	cioh
tshiə̄	chio
tshiə̌	chiox
tshiə̀	chioh
dziə̌	ziox
siə̄	sio
siə̌	siox
siə̀	sioh
ziə̄	zsio
ziə̌	zsiox
ziə̀	zsioh
tšiə̄	crio
tšiə̌	criox
tšiə̀	crioh
tšhiə̄	chrio
tšhiə̌	chriox
tšhiə̀	chrioh
džiə̄	zrio
džiə̌	zriox
džiə̀	zrioh
šiə̄	srio
šiə̌	sriox
šiə̀	srioh
tśiə̄	cjo
tśiə̌	cjox
tśiə̀	cjoh
tśhiə̌	chjox
tśhiə̀	chjoh
dźiə̄	zjo
dźiə̌	zjox
dźiə̀	zjoh
ńiə̄	njo
ńiə̌	njox
ńiə̀	njoh
śiə̄	sjo
śiə̌	sjox
śiə̀	sjoh
źiə̌	zsjox
kiə̄	kio
kiə̌	kiox
kiə̀	kioh
khiə̄	khio
khiə̌	khiox
khiə̀	khioh
giə̄	gio
giə̌	giox
giə̀	gioh
ŋiə̄	ngio
ŋiə̌	ngiox
ŋiə̀	ngioh
hiə̄	hio
hiə̌	hiox
hiə̀	hioh
ȝiə̄	qio
ȝiə̌	qiox
ȝiə̀	qioh
jiə̄	jo
jiə̌	jox
jiə̀	joh
püō	pyo
püǒ	pyox
püò	pyoh
phüō	phyo
phüǒ	phyox
phüò	phyoh
büō	byo
büǒ	byox
büò	byoh
müō	myo
müǒ	myox
müò	myoh
lüō	lyo
lüǒ	lyox
lüò	lyoh
ṭüō	tryo
ṭüǒ	tryox
ṭüò	tryoh
ṭhüō	thryo
ṭhüò	thryoh
ḍüō	dryo
ḍüǒ	dryox
ḍüò	dryoh
tsüō	cyo
tsüò	cyoh
tshüō	chyo
tshüǒ	chyox
tshüò	chyoh
dzüǒ	zyox
dzüò	zyoh
süō	syo
süǒ	syox
süò	syoh
tšüō	cryo
tšhüō	chryo
tšhüò	chryoh
džüō	zryo
džüǒ	zryox
šüō	sryo
šüǒ	sryox
šüò	sryoh
tśüō	cjyo
tśüǒ	cjyox
tśüò	cjyoh
tśhüō	chjyo
dźüō	zjyo
dźüǒ	zjyox
dźüò	zjyoh
ńüō	njyo
ńüǒ	njyox
ńüò	njyoh
śüō	sjyo
śüò	sjyoh
küō	kyo
küǒ	kyox
küò	kyoh
khüō	khyo
khüǒ	khyox
khüò	khyoh
güō	gyo
güǒ	gyox
güò	gyoh
ŋüō	ngyo
ŋüǒ	ngyox
ŋüò	ngyoh
hüō	hyo
hüǒ	hyox
hüò	hyoh
ȝüō	qyo
ȝüǒ	qyox
ȝüò	qyoh
jüō	jyo
jüǒ	jyox
jüò	jyoh
üō	yo
üǒ	yox
üò	yoh
pū	po
pǔ	pox
pù	poh
phū	pho
phǔ	phox
phù	phoh
bū	bo
bǔ	box
bù	boh
mū	mo
mǔ	mox
mù	moh
tū	to
tǔ	tox
tù	toh
thū	tho
thǔ	thox
thù	thoh
dū	do
dǔ	dox
dù	doh
nū	no
nǔ	nox
nù	noh
lū	lo
lǔ	lox
lù	loh
tsū	co
tsǔ	cox
tsù	coh
tshū	cho
tshǔ	chox
tshù	choh
dzū	zo
dzǔ	zox
dzù	zoh
sū	so
sù	soh
kū	ko
kǔ	kox
kù	koh
khū	kho
khǔ	khox
khù	khoh
ŋū	ngo
ŋǔ	ngox
ŋù	ngoh
hū	ho
hǔ	hox
hù	hoh
ĥū	gho
ĥǔ	ghox
ĥù	ghoh
ȝū	qo
ȝǔ	qox
ȝù	qoh
dźēi	zje
ńēi	nje
pēi	pe
pěi	pex
pèi	peh
phēi	phe
phěi	phex
phèi	pheh
bēi	be
běi	bex
bèi	beh
mēi	me
měi	mex
mèi	meh
tēi	te
těi	tex
tèi	teh
thēi	the
thěi	thex
thèi	theh
dēi	de
děi	dex
dèi	deh
nēi	ne
něi	nex
nèi	neh
lēi	le
lěi	lex
lèi	leh
tsēi	ce
tsěi	cex
tsèi	ceh
tshēi	che
tshěi	chex
tshèi	cheh
dzēi	ze
dzěi	zex
dzèi	zeh
sēi	se
sěi	sex
sèi	seh
kēi	ke
kèi	keh
khēi	khe
khěi	khex
khèi	kheh
ŋēi	nge
ŋěi	ngex
ŋèi	ngeh
hēi	he
hèi	heh
ĥēi	ghe
ĥěi	ghex
ĥèi	gheh
ȝēi	qe
ȝěi	qex
ȝèi	qeh
kuēi	kue
kuèi	kueh
khuēi	khue
huēi	hue
huèi	hueh
ĥuēi	ghue
ĥuèi	ghueh
ȝuēi	que
pьièi	pjed
phьièi	phjed
bьièi	bjed
mьièi	mjed
lьièi	lied
tsьièi	cied
tśьièi	cjed
tśhьièi	chjed
dźьièi	zjed
śьièi	sjed
ŋьièi	ngjed
jьièi	jed
tsьüèi	cyed
tshьüèi	chyed
sьüèi	syed
zьüèi	zsyed
tśьüèi	cjyed
dźьüèi	zjyed
ńьüèi	njyed
śьüèi	sjyed
jьüèi	jyed
ṭièi	tried
ṭhièi	thried
ḍièi	dried
šièi	sried
kièi	kied
khièi	khied
gièi	gied
ŋièi	ngied
ȝièi	qied
ṭüèi	tryed
ḍüèi	dryed
tšhüèi	chryed
šüèi	sryed
küèi	kyed
üèi	yed
pài	pad
phài	phad
bài	bad
mài	mad
tài	tad
thài	thad
dài	dad
nài	nad
lài	lad
tshài	chad
kài	kad
khài	khad
ŋài	ngad
hài	had
ĥài	ghad
ȝài	qad
tuài	tuad
thuài	thuad
duài	duad
luài	luad
tsuài	cuad
tshuài	chuad
dzuài	zuad
suài	suad
kuài	kuad
khuài	khuad
ŋuài	nguad
huài	huad
ĥuài	ghuad
ȝuài	quad
pɛ̌	prex
pɛ̀	preh
phɛ̀	phreh
bɛ̄	bre
bɛ̌	brex
bɛ̀	breh
mɛ̄	mre
mɛ̌	mrex
mɛ̀	mreh
ṭɛ̀	treh
ṭhɛ̄	thre
ḍɛ̌	drex
ṇɛ̄	nre
ṇɛ̌	nrex
tšɛ̀	creh
tšhɛ̄	chre
tšhɛ̀	chreh
džɛ̄	zre
džɛ̀	zreh
šɛ̄	sre
šɛ̌	srex
šɛ̀	sreh
kɛ̄	kre
kɛ̌	krex
kɛ̀	kreh
khɛ̌	khrex
khɛ̀	khreh
gɛ̌	grex
ŋɛ̄	ngre
ŋɛ̀	ngreh
hɛ̄	hre
hɛ̀	hreh
ĥɛ̄	ghre
ĥɛ̌	ghrex
ĥɛ̀	ghreh
ȝɛ̄	qre
ȝɛ̌	qrex
ȝɛ̀	qreh
ḍuɛ̌	druex
kuɛ̄	krue
kuɛ̌	kruex
kuɛ̀	krueh
khuɛ̄	khrue
huɛ̄	hrue
huɛ̌	hruex
huɛ̀	hrueh
ĥuɛ̄	ghrue
ĥuɛ̌	ghruex
ĥuɛ̀	ghrueh
ȝuɛ̄	qrue
pɛ̀i	praih
phɛ̀i	phraih
bɛ̄i	brai
bɛ̀i	braih
mɛ̄i	mrai
mɛ̀i	mraih
lɛ̄i	lrai
ṭɛ̄i	trai
ṭhɛ̄i	thrai
ṇɛ̄i	nrai
ṇɛ̀i	nraih
tšɛ̄i	crai
tšɛ̀i	craih
tšhɛ̄i	chrai
džɛ̄i	zrai
šɛ̄i	srai
šɛ̀i	sraih
kɛ̄i	krai
kɛ̀i	kraih
khɛ̄i	khrai
khɛ̌i	khraix
khɛ̀i	khraih
ŋɛ̄i	ngrai
ŋɛ̌i	ngraix
ŋɛ̀i	ngraih
hɛ̄i	hrai
hɛ̀i	hraih
ĥɛ̄i	ghrai
ĥɛ̌i	ghraix
ĥɛ̀i	ghraih
ȝɛ̄i	qrai
ȝɛ̌i	qraix
ȝɛ̀i	qraih
luɛ̄i	lruai
ṭuɛ̀i	truaih
ḍuɛ̄i	druai
džuɛ̄i	zruai
kuɛ̄i	kruai
kuɛ̀i	kruaih
khuɛ̄i	khruai
khuɛ̀i	khruaih
ŋuɛ̀i	ngruaih
huɛ̄i	hruai
huɛ̀i	hruaih
ĥuɛ̄i	ghruai
ĥuɛ̀i	ghruaih
ȝuɛ̄i	qruai
pæ̀i	prad
bæ̀i	brad
mæ̀i	mrad
ṭhæ̀i	thrad
ḍæ̀i	drad
džæ̀i	zrad
šæ̀i	srad
kæ̀i	krad
hæ̀i	hrad
ĥæ̀i	ghrad
ȝæ̀i	qrad
tšhuæ̀i	chruad
kuæ̀i	kruad
khuæ̀i	khruad
huæ̀i	hruad
ĥuæ̀i	ghruad
ȝuæ̀i	qruad
puōi	puai
puòi	puaih
phuōi	phuai
phuǒi	phuaix
phuòi	phuaih
buōi	buai
buǒi	buaix
buòi	buaih
muōi	muai
muǒi	muaix
muòi	muaih
tuōi	tuai
tuǒi	tuaix
tuòi	tuaih
thuōi	thuai
thuǒi	thuaix
thuòi	thuaih
duōi	duai
duǒi	duaix
duòi	duaih
nuōi	nuai
nuǒi	nuaix
nuòi	nuaih
luōi	luai
luǒi	luaix
luòi	luaih
tsuōi	cuai
tsuǒi	cuaix
tsuòi	cuaih
tshuōi	chuai
tshuǒi	chuaix
tshuòi	chuaih
dzuōi	zuai
dzuǒi	zuaix
suōi	suai
suòi	suaih
kuōi	kuai
kuòi	kuaih
khuōi	khuai
khuǒi	khuaix
khuòi	khuaih
ŋuōi	nguai
ŋuǒi	nguaix
ŋuòi	nguaih
huōi	huai
huǒi	huaix
huòi	huaih
ĥuōi	ghuai
ĥuǒi	ghuaix
ĥuòi	ghuaih
ȝuōi	quai
ȝuǒi	quaix
ȝuòi	quaih
tōi	tai
tǒi	taix
tòi	taih
thōi	thai
thǒi	thaix
thòi	thaih
dōi	dai
dǒi	daix
dòi	daih
nōi	nai
nǒi	naix
nòi	naih
lōi	lai
lǒi	laix
lòi	laih
tsōi	cai
tsǒi	caix
tsòi	caih
tshōi	chai
tshǒi	chaix
tshòi	chaih
dzōi	zai
dzǒi	zaix
dzòi	zaih
sōi	sai
sòi	saih
kōi	kai
kǒi	kaix
kòi	kaih
khōi	khai
khǒi	khaix
khòi	khaih
ŋōi	ngai
ŋòi	ngaih
hōi	hai
hǒi	haix
hòi	haih
ĥōi	ghai
ĥǒi	ghaix
ĥòi	ghaih
ȝōi	qai
ȝǒi	qaix
ȝòi	qaih
tśhiōi	chjai
tśhiǒi	chjaix
ńiǒi	njaix
jiǒi	jaix
ŋiòi	ngiad
püòi	pyad
phüòi	phyad
büòi	byad
khüòi	khyad
güòi	gyad
hüòi	hyad
ȝüòi	qyad
pьīn	pjin
pьìn	pjinh
pьi̍t	pjit
phьīn	phjin
phьìn	phjinh
phьi̍t	phjit
bьīn	bjin
bьǐn	bjinx
bьi̍t	bjit
mьīn	mjin
mьǐn	mjinx
mьi̍t	mjit
lьīn	lin
lьǐn	linx
lьìn	linh
lьi̍t	lit
tsьīn	cin
tsьǐn	cinx
tsьìn	cinh
tsьi̍t	cit
tshьīn	chin
tshьǐn	chinx
tshьìn	chinh
tshьi̍t	chit
dzьīn	zin
dzьǐn	zinx
dzьi̍t	zit
sьīn	sin
sьìn	sinh
sьi̍t	sit
zьìn	zsinh
tśьīn	cjin
tśьǐn	cjinx
tśьìn	cjinh
tśьi̍t	cjit
tśhьīn	chjin
tśhьi̍t	chjit
dźьīn	zjin
dźьǐn	zjinx
dźьìn	zjinh
ńьīn	njin
ńьǐn	njinx
ńьìn	njinh
ńьi̍t	njit
śьīn	sjin
śьǐn	sjinx
śьìn	sjinh
śьi̍t	sjit
źьīn	zsjin
źьi̍t	zsjit
kьǐn	kjinx
kьi̍t	kjit
khьǐn	khjinx
khьìn	khjinh
khьi̍t	khjit
gьīn	gjin
hьi̍t	hjit
ȝьīn	qjin
ȝьìn	qjinh
ȝьi̍t	qjit
jьīn	jin
jьǐn	jinx
jьìn	jinh
jьi̍t	jit
ьīn	in
lьüīn	lyn
lьüǐn	lynx
lьüi̍t	lyt
tsьüīn	cyn
tsьüìn	cynh
tsьüi̍t	cyt
tshьüīn	chyn
tshьüi̍t	chyt
dzьüīn	zyn
dzьüi̍t	zyt
sьüīn	syn
sьüǐn	synx
sьüìn	synh
sьüi̍t	syt
zьüīn	zsyn
zьüìn	zsynh
tśьüīn	cjyn
tśьüǐn	cjynx
tśьüìn	cjynh
tśhьüīn	chjyn
tśhьüǐn	chjynx
tśhьüi̍t	chjyt
dźьüīn	zjyn
ńьüīn	njyn
ńьüǐn	njynx
ńьüìn	njynh
śьüǐn	sjynx
śьüìn	sjynh
źьüīn	zsjyn
źьüǐn	zsjynx
źьüìn	zsjynh
źьüi̍t	zsjyt
kьüīn	kjyn
kьüìn	kjynh
kьüi̍t	kjyt
hьüi̍t	hjyt
jьüīn	jyn
jьüǐn	jynx
jьüi̍t	jyt
pīn	pin
pi̍t	pit
phīn	phin
bīn	bin
bi̍t	bit
mīn	min
mǐn	minx
mi̍t	mit
ṭīn	trin
ṭǐn	trinx
ṭìn	trinh
ṭi̍t	trit
ṭhīn	thrin
ṭhǐn	thrinx
ṭhìn	thrinh
ṭhi̍t	thrit
ḍīn	drin
ḍǐn	drinx
ḍìn	drinh
ḍi̍t	drit
ṇīn	nrin
ṇi̍t	nrit
tšhìn	chrinh
tšhi̍t	chrit
džǐn	zrinx
dži̍t	zrit
kīn	kin
ki̍t	kit
gīn	gin
gìn	ginh
gi̍t	git
ŋīn	ngin
ŋǐn	nginx
ŋìn	nginh
ŋi̍t	ngit
hǐn	hinx
hìn	hinh
hi̍t	hit
ȝīn	qin
ȝi̍t	qit
ṭüīn	tryn
ṭüi̍t	tryt
ṭhüīn	thryn
ṭhüǐn	thrynx
ṭhüi̍t	thryt
ḍüīn	dryn
ḍüi̍t	dryt
tšüi̍t	cryt
šüi̍t	sryt
küīn	kyn
khüīn	khyn
khüǐn	khynx
güǐn	gynx
ȝüīn	qyn
üīn	yn
üǐn	ynx
üi̍t	yt
tšīn	crin
tši̍t	crit
džīn	zrin
dži̍t	zrit
šīn	srin
ši̍t	srit
püūn	pyon
püǔn	pyonx
püùn	pyonh
püu̍t	pyot
phüūn	phyon
phüǔn	phyonx
phüùn	phyonh
phüu̍t	phyot
büūn	byon
büǔn	byonx
büùn	byonh
büu̍t	byot
müūn	myon
müǔn	myonx
müùn	myonh
müu̍t	myot
küūn	kyon
küùn	kyonh
küu̍t	kyot
khüǔn	khyonx
khüu̍t	khyot
güūn	gyon
güùn	gyonh
güu̍t	gyot
ŋüǔn	ngyonx
ŋüu̍t	ngyot
hüūn	hyon
hüùn	hyonh
hüu̍t	hyot
ȝüūn	qyon
ȝüǔn	qyonx
ȝüùn	qyonh
ȝüu̍t	qyot
üūn	yon
üǔn	yonx
üùn	yonh
üu̍t	yot
tšiə̌n	crionx
tšhiə̌n	chrionx
kiə̄n	kion
kiə̌n	kionx
kiə̀n	kionh
kiə̍t	kiot
khiə̌n	khionx
khiə̍t	khiot
giə̄n	gion
giə̌n	gionx
giə̀n	gionh
giə̍t	giot
ŋiə̄n	ngion
ŋiə̌n	ngionx
ŋiə̀n	ngionh
ŋiə̍t	ngiot
hiə̄n	hion
hiə̌n	hionx
hiə̀n	hionh
hiə̍t	hiot
ȝiə̄n	qion
ȝiə̌n	qionx
ȝiə̀n	qionh
puōn	puon
puǒn	puonx
puòn	puonh
phuōn	phuon
phuǒn	phuonx
phuòn	phuonh
phuo̍t	phuot
buōn	buon
buǒn	buonx
buòn	buonh
buo̍t	buot
muōn	muon
muǒn	muonx
muòn	muonh
muo̍t	muot
tuōn	tuon
tuòn	tuonh
tuo̍t	tuot
thuōn	thuon
thuǒn	thuonx
thuo̍t	thuot
duōn	duon
duǒn	duonx
duòn	duonh
duo̍t	duot
nuōn	nuon
nuǒn	nuonx
nuòn	nuonh
nuo̍t	nuot
luōn	luon
luǒn	luonx
luòn	luonh
luo̍t	luot
tsuōn	cuon
tsuǒn	cuonx
tsuòn	cuonh
tsuo̍t	cuot
tshuōn	chuon
tshuǒn	chuonx
tshuòn	chuonh
tshuo̍t	chuot
dzuōn	zuon
dzuǒn	zuonx
dzuòn	zuonh
dzuo̍t	zuot
suōn	suon
suǒn	suonx
suòn	suonh
suo̍t	suot
kuōn	kuon
kuǒn	kuonx
kuòn	kuonh
kuo̍t	kuot
khuōn	khuon
khuǒn	khuonx
khuòn	khuonh
khuo̍t	khuot
ŋuōn	nguon
ŋuòn	nguonh
ŋuo̍t	nguot
huōn	huon
huǒn	huonx
huòn	huonh
huo̍t	huot
ĥuōn	ghuon
ĥuǒn	ghuonx
ĥuòn	ghuonh
ĥuo̍t	ghuot
ȝuōn	quon
ȝuǒn	quonx
ȝuòn	quonh
ȝuo̍t	quot
thōn	thon
kōn	kon
kǒn	konx
kòn	konh
khǒn	khonx
ŋōn	ngon
ŋòn	ngonh
ĥōn	ghon
ĥǒn	ghonx
ĥòn	ghonh
ĥo̍t	ghot
ȝōn	qon
ȝòn	qonh
kiōn	kian
kiǒn	kianx
kiòn	kianh
kio̍t	kiat
khiōn	khian
khiǒn	khianx
giōn	gian
giǒn	gianx
giòn	gianh
gio̍t	giat
ŋiōn	ngian
ŋiǒn	ngianx
ŋiòn	ngianh
ŋio̍t	ngiat
hiōn	hian
hiǒn	hianx
hiòn	hianh
hio̍t	hiat
ȝiōn	qian
ȝiǒn	qianx
ȝiòn	qianh
ȝio̍t	qiat
püōn	pyan
püǒn	pyanx
püòn	pyanh
püo̍t	pyat
phüōn	phyan
phüòn	phyanh
phüo̍t	phyat
büōn	byan
büǒn	byanx
büòn	byanh
büo̍t	byat
müōn	myan
müǒn	myanx
müòn	myanh
müo̍t	myat
tšhüòn	chryanh
küòn	kyanh
küo̍t	kyat
khüǒn	khyanx
khüòn	khyanh
khüo̍t	khyat
güǒn	gyanx
güòn	gyanh
güo̍t	gyat
ŋüōn	ngyan
ŋüǒn	ngyanx
ŋüòn	ngyanh
ŋüo̍t	ngyat
hüōn	hyan
hüǒn	hyanx
hüòn	hyanh
hüo̍t	hyat
ȝüōn	qyan
ȝüǒn	qyanx
ȝüòn	qyanh
ȝüo̍t	qyat
üōn	yan
üǒn	yanx
üòn	yanh
üo̍t	yat
pān	puan
pǎn	puanx
pàn	puanh
pa̍t	puat
phān	phuan
phǎn	phuanx
phàn	phuanh
pha̍t	phuat
bān	buan
bǎn	buanx
bàn	buanh
ba̍t	buat
mān	muan
mǎn	muanx
màn	muanh
ma̍t	muat
tān	tan
tǎn	tanx
tàn	tanh
ta̍t	tat
thān	than
thǎn	thanx
thàn	thanh
tha̍t	that
dān	dan
dǎn	danx
dàn	danh
da̍t	dat
nān	nan
nǎn	nanx
nàn	nanh
na̍t	nat
lān	lan
lǎn	lanx
làn	lanh
la̍t	lat
tsǎn	canx
tsàn	canh
tsa̍t	cat
tshān	chan
tshàn	chanh
tsha̍t	chat
dzān	zan
dzǎn	zanx
dzàn	zanh
dza̍t	zat
sān	san
sǎn	sanx
sàn	sanh
sa̍t	sat
kān	kan
kǎn	kanx
kàn	kanh
ka̍t	kat
khān	khan
khǎn	khanx
khàn	khanh
kha̍t	khat
ŋān	ngan
ŋàn	nganh
ŋa̍t	ngat
hān	han
hǎn	hanx
hàn	hanh
ha̍t	hat
ĥān	ghan
ĥǎn	ghanx
ĥàn	ghanh
ĥa̍t	ghat
ȝān	qan
ȝàn	qanh
ȝa̍t	qat
tuān	tuan
tuǎn	tuanx
tuàn	tuanh
tua̍t	tuat
thuān	thuan
thuǎn	thuanx
thuàn	thuanh
thua̍t	thuat
duān	duan
duǎn	duanx
duàn	duanh
dua̍t	duat
nuān	nuan
nuǎn	nuanx
nuàn	nuanh
luān	luan
luǎn	luanx
luàn	luanh
lua̍t	luat
tsuān	cuan
tsuǎn	cuanx
tsuàn	cuanh
tsua̍t	cuat
tshuàn	chuanh
tshua̍t	chuat
dzuān	zuan
dzuàn	zuanh
dzua̍t	zuat
suān	suan
suǎn	suanx
suàn	suanh
zuǎn	zsuanx
kuān	kuan
kuǎn	kuanx
kuàn	kuanh
kua̍t	kuat
khuān	khuan
khuǎn	khuanx
khuàn	khuanh
khua̍t	khuat
ŋuān	nguan
ŋuàn	nguanh
ŋua̍t	nguat
huān	huan
huàn	huanh
hua̍t	huat
ĥuān	ghuan
ĥuǎn	ghuanx
ĥuàn	ghuanh
ĥua̍t	ghuat
ȝuān	quan
ȝuǎn	quanx
ȝuàn	quanh
ȝua̍t	quat
jia̍t	jat
pǣn	pran
pæ̌n	pranx
pæ̍t	prat
phǣn	phran
phæ̌n	phranx
phæ̀n	phranh
bæ̌n	branx
mǣn	mran
mæ̌n	mranx
mæ̀n	mranh
mæ̍t	mrat
ṭæ̍t	trat
ṭhæ̀n	thranh
ṭhæ̍t	thrat
ṇæ̌n	nranx
tšæ̌n	cranx
tšhæ̌n	chranx
tšhæ̀n	chranh
tšhæ̍t	chrat
džæ̌n	zranx
džæ̀n	zranh
džæ̍t	zrat
šǣn	sran
šæ̌n	sranx
šæ̀n	sranh
kǣn	kran
kæ̀n	kranh
kæ̍t	krat
khǣn	khran
khæ̍t	khrat
ŋǣn	ngran
ŋæ̌n	ngranx
ŋæ̀n	ngranh
ŋæ̍t	ngrat
hæ̍t	hrat
ĥæ̌n	ghranx
ĥæ̀n	ghranh
ĥæ̍t	ghrat
ȝæ̀n	qranh
ȝæ̍t	qrat
ṭuæ̍t	truat
ṭhuæ̍t	thruat
ṇuǣn	nruan
ṇuæ̀n	nruanh
ṇuæ̍t	nruat
tšuǣn	cruan
tšhuæ̀n	chruanh
tšhuæ̍t	chruat
džuæ̌n	zruanx
šuǣn	sruan
šuæ̀n	sruanh
šuæ̍t	sruat
kuǣn	kruan
kuæ̀n	kruanh
kuæ̍t	kruat
ŋuǣn	ngruan
ŋuæ̀n	ngruanh
ŋuæ̍t	ngruat
ĥuǣn	ghruan
ĥuæ̌n	ghruanx
ĥuæ̀n	ghruanh
ĥuæ̍t	ghruat
ȝuǣn	qruan
ȝuæ̌n	qruanx
ȝuæ̀n	qruanh
ńiæ̍t	njrat
pɛ̄n	pren
pɛ̀n	prenh
pɛ̍t	pret
phɛ̀n	phrenh
phɛ̍t	phret
bɛ̀n	brenh
bɛ̍t	bret
mɛ̌n	mrenx
mɛ̀n	mrenh
mɛ̍t	mret
lɛ̄n	lren
ṭɛ̄n	tren
ḍɛ̄n	dren
ḍɛ̀n	drenh
ṇɛ̄n	nren
ṇɛ̍t	nret
tšɛ̌n	crenx
tšɛ̍t	cret
tšhɛ̌n	chrenx
tšhɛ̍t	chret
džɛ̄n	zren
džɛ̌n	zrenx
šɛ̄n	sren
šɛ̌n	srenx
šɛ̍t	sret
kɛ̄n	kren
kɛ̌n	krenx
kɛ̀n	krenh
kɛ̍t	kret
khɛ̄n	khren
khɛ̌n	khrenx
khɛ̍t	khret
ŋɛ̄n	ngren
ŋɛ̌n	ngrenx
hɛ̄n	hren
ĥɛ̄n	ghren
ĥɛ̌n	ghrenx
ĥɛ̀n	ghrenh
ĥɛ̍t	ghret
ȝɛ̄n	qren
ȝɛ̍t	qret
luɛ̄n	lruen
ṭuɛ̍t	truet
ḍuɛ̄n	druen
ṇuɛ̍t	nruet
tšuɛ̍t	cruet
tšhuɛ̌n	chruenx
kuɛ̄n	kruen
kuɛ̀n	kruenh
kuɛ̍t	kruet
khuɛ̍t	khruet
guɛ̄n	gruen
ŋuɛ̍t	ngruet
huɛ̍t	hruet
ĥuɛ̄n	ghruen
ĥuɛ̀n	ghruenh
ĥuɛ̍t	ghruet
ȝuɛ̄n	qruen
ȝuɛ̍t	qruet
tśhiɛ̄n	chjren
pēn	pen
pěn	penx
pèn	penh
pe̍t	pet
phèn	phenh
phe̍t	phet
bēn	ben
běn	benx
be̍t	bet
mēn	men
měn	menx
mèn	menh
me̍t	met
tēn	ten
těn	tenx
tèn	tenh
te̍t	tet
thēn	then
thěn	thenx
thèn	thenh
the̍t	thet
dēn	den
děn	denx
dèn	denh
de̍t	det
nēn	nen
něn	nenx
nèn	nenh
ne̍t	net
lēn	len
lèn	lenh
le̍t	let
tsēn	cen
tsèn	cenh
tse̍t	cet
tshēn	chen
tshèn	chenh
tshe̍t	chet
dzēn	zen
dzèn	zenh
dze̍t	zet
sēn	sen
sěn	senx
sèn	senh
se̍t	set
kēn	ken
kěn	kenx
kèn	kenh
ke̍t	ket
khēn	khen
khěn	khenx
khèn	khenh
khe̍t	khet
ŋēn	ngen
ŋěn	ngenx
ŋèn	ngenh
ŋe̍t	nget
hēn	hen
hěn	henx
hèn	henh
he̍t	het
ĥēn	ghen
ĥěn	ghenx
ĥèn	ghenh
ĥe̍t	ghet
ȝēn	qen
ȝěn	qenx
ȝèn	qenh
ȝe̍t	qet
džuēn	zruen
kuēn	kuen
kuěn	kuenx
kuèn	kuenh
kue̍t	kuet
khuěn	khuenx
khue̍t	khuet
huēn	huen
huèn	huenh
hue̍t	huet
ĥuēn	ghuen
ĥuěn	ghuenx
ĥuèn	ghuenh
ĥue̍t	ghuet
ȝuēn	quen
ȝuèn	quenh
ȝue̍t	quet
pьiēn	pjen
pьiěn	pjenx
pьie̍t	pjet
phьiēn	phjen
phьièn	phjenh
phьie̍t	phjet
bьiēn	bjen
bьiěn	bjenx
bьièn	bjenh
mьiēn	mjen
mьiěn	mjenx
mьièn	mjenh
mьie̍t	mjet
lьiēn	lien
lьiěn	lienx
lьièn	lienh
lьie̍t	liet
tsьiēn	cien
tsьiěn	cienx
tsьièn	cienh
tsьie̍t	ciet
tshьiēn	chien
tshьiěn	chienx
dzьiēn	zien
dzьiěn	zienx
dzьièn	zienh
sьiēn	sien
sьiěn	sienx
sьièn	sienh
sьie̍t	siet
zьiēn	zsien
zьiěn	zsienx
zьièn	zsienh
tśьiēn	cjen
tśьiěn	cjenx
tśьièn	cjenh
tśьie̍t	cjet
tśhьiēn	chjen
tśhьiěn	chjenx
tśhьièn	chjenh
tśhьie̍t	chjet
dźьiēn	zjen
dźьiěn	zjenx
dźьièn	zjenh
dźьie̍t	zjet
ńьiēn	njen
ńьiěn	njenx
ńьie̍t	njet
śьiēn	sjen
śьiěn	sjenx
śьièn	sjenh
śьie̍t	sjet
źьie̍t	zsjet
kьiēn	kjen
kьie̍t	kjet
khьiěn	khjenx
khьièn	khjenh
ȝьièn	qjenh
jьiēn	jen
jьiěn	jenx
jьièn	jenh
jьie̍t	jet
lьüēn	lyen
lьüěn	lyenx
lьüèn	lyenh
lьüe̍t	lyet
tsьüēn	cyen
tsьüěn	cyenx
tsьüe̍t	cyet
tshьüēn	chyen
tshьüèn	chyenh
tshьüe̍t	chyet
dzьüēn	zyen
dzьüěn	zyenx
dzьüe̍t	zyet
sьüēn	syen
sьüěn	syenx
sьüèn	syenh
sьüe̍t	syet
zьüēn	zsyen
zьüèn	zsyenh
zьüe̍t	zsyet
tśьüēn	cjyen
tśьüěn	cjyenx
tśьüèn	cjyenh
tśьüe̍t	cjyet
tśhьüēn	chjyen
tśhьüěn	chjyenx
tśhьüèn	chjyenh
tśhьüe̍t	chjyet
dźьüēn	zjyen
dźьüěn	zjyenx
dźьüèn	zjyenh
dźьüe̍t	zjyet
ńьüēn	njyen
ńьüěn	njyenx
ńьüèn	njyenh
ńьüe̍t	njyet
śьüe̍t	sjyet
źьüēn	zsjyen
kьüèn	kjyenh
khьüe̍t	khjyet
gьüěn	gjyenx
hьüēn	hjyen
hьüěn	hjyenx
hьüe̍t	hjyet
ȝьüēn	qjyen
ȝьüe̍t	qjyet
jьüēn	jyen
jьüěn	jyenx
jьüèn	jyenh
jьüe̍t	jyet
piěn	pienx
pièn	pienh
pie̍t	piet
phiěn	phienx
biěn	bienx
bièn	bienh
bie̍t	biet
miěn	mienx
ṭiēn	trien
ṭiěn	trienx
ṭièn	trienh
ṭie̍t	triet
ṭhiēn	thrien
ṭhiěn	thrienx
ṭhie̍t	thriet
ḍiēn	drien
ḍiěn	drienx
ḍièn	drienh
ḍie̍t	driet
ṇiěn	nrienx
ṇièn	nrienh
džiēn	zrien
džiěn	zrienx
džie̍t	zriet
šie̍t	sriet
kiěn	kienx
khiēn	khien
khie̍t	khiet
giēn	gien
giěn	gienx
gie̍t	giet
ŋiěn	ngienx
ŋièn	ngienh
ŋie̍t	ngiet
hiēn	hien
hie̍t	hiet
ȝiēn	qien
ȝiěn	qienx
ȝie̍t	qiet
iēn	ien
ṭüēn	tryen
ṭüěn	tryenx
ṭüèn	tryenh
ṭüe̍t	tryet
ṭhüēn	thryen
ṭhüèn	thryenh
ṭhüe̍t	thryet
ḍüēn	dryen
ḍüěn	dryenx
ḍüèn	dryenh
ṇüe̍t	nryet
tšüēn	cryen
tšüèn	cryenh
tšüe̍t	cryet
tšhüe̍t	chryet
džüěn	zryenx
džüèn	zryenh
šüēn	sryen
šüèn	sryenh
šüe̍t	sryet
küēn	kyen
küěn	kyenx
küèn	kyenh
küe̍t	kyet
khüēn	khyen
khüèn	khyenh
güēn	gyen
güěn	gyenx
güèn	gyenh
ȝüēn	qyen
ȝüe̍t	qyet
üēn	yen
üèn	yenh
tēu	teu
těu	teux
tèu	teuh
thēu	theu
thěu	theux
thèu	theuh
dēu	deu
děu	deux
dèu	deuh
něu	neux
nèu	neuh
lēu	leu
lěu	leux
lèu	leuh
tsěu	ceux
sēu	seu
sěu	seux
sèu	seuh
kēu	keu
kěu	keux
kèu	keuh
khēu	kheu
khěu	kheux
khèu	kheuh
ŋēu	ngeu
ŋèu	ngeuh
hēu	heu
hěu	heux
hèu	heuh
ĥěu	gheux
ȝēu	qeu
ȝěu	qeux
ȝèu	qeuh
pьiēu	pjeu
pьiěu	pjeux
phьiēu	phjeu
phьiěu	phjeux
phьièu	phjeuh
bьiēu	bjeu
bьiěu	bjeux
bьièu	bjeuh
mьiēu	mjeu
mьiěu	mjeux
mьièu	mjeuh
lьiēu	lieu
lьiěu	lieux
lьièu	lieuh
tsьiēu	cieu
tsьiěu	cieux
tsьièu	cieuh
tshьiēu	chieu
tshьiěu	chieux
tshьièu	chieuh
dzьiēu	zieu
dzьièu	zieuh
sьiēu	sieu
sьiěu	sieux
sьièu	sieuh
tśьiēu	cjeu
tśьiěu	cjeux
tśьièu	cjeuh
tśhьiēu	chjeu
tśhьiěu	chjeux
dźьiēu	zjeu
dźьiěu	zjeux
dźьièu	zjeuh
ńьiēu	njeu
ńьiěu	njeux
ńьièu	njeuh
śьiēu	sjeu
śьiěu	sjeux
śьièu	sjeuh
khьiēu	khjeu
gьiēu	gjeu
gьièu	gjeuh
ȝьiēu	qjeu
ȝьiěu	qjeux
ȝьièu	qjeuh
jьiēu	jeu
jьiěu	jeux
jьièu	jeuh
piēu	pieu
piěu	pieux
pièu	pieuh
phiěu	phieux
biěu	bieux
miēu	mieu
mièu	mieuh
ṭiēu	trieu
ṭhiēu	thrieu
ṭhiěu	thrieux
ṭhièu	thrieuh
ḍiēu	drieu
ḍiěu	drieux
ḍièu	drieuh
kiēu	kieu
kiěu	kieux
khiēu	khieu
khièu	khieuh
giēu	gieu
giěu	gieux
gièu	gieuh
ŋièu	ngieuh
hiēu	hieu
ȝiēu	qieu
ȝiěu	qieux
iēu	ieu
pǣu	prau
pæ̌u	praux
pæ̀u	prauh
phǣu	phrau
phæ̀u	phrauh
bǣu	brau
bæ̌u	braux
bæ̀u	brauh
mǣu	mrau
mæ̌u	mraux
mæ̀u	mrauh
lǣu	lrau
ṭǣu	trau
ṭæ̌u	traux
ṭæ̀u	trauh
ṭhǣu	thrau
ṭhæ̀u	thrauh
ḍǣu	drau
ḍæ̀u	drauh
ṇǣu	nrau
ṇæ̌u	nraux
ṇæ̀u	nrauh
tšǣu	crau
tšæ̌u	craux
tšæ̀u	crauh
tšhǣu	chrau
tšhæ̌u	chraux
tšhæ̀u	chrauh
džǣu	zrau
džæ̌u	zraux
džæ̀u	zrauh
šǣu	srau
šæ̌u	sraux
šæ̀u	srauh
kǣu	krau
kæ̌u	kraux
kæ̀u	krauh
khǣu	khrau
khæ̌u	khraux
khæ̀u	khrauh
ŋǣu	ngrau
ŋæ̌u	ngraux
ŋæ̀u	ngrauh
hǣu	hrau
hæ̀u	hrauh
ĥǣu	ghrau
ĥæ̌u	ghraux
ĥæ̀u	ghrauh
ȝǣu	qrau
ȝæ̌u	qraux
ȝæ̀u	qrauh
pāu	pau
pǎu	paux
pàu	pauh
phāu	phau
bāu	bau
bǎu	baux
bàu	bauh
māu	mau
mǎu	maux
màu	mauh
tāu	tau
tǎu	taux
tàu	tauh
thāu	thau
thǎu	thaux
dāu	dau
dǎu	daux
dàu	dauh
nāu	nau
nǎu	naux
nàu	nauh
lāu	lau
lǎu	laux
làu	lauh
tsāu	cau
tsǎu	caux
tsàu	cauh
tshāu	chau
tshǎu	chaux
tshàu	chauh
dzāu	zau
dzǎu	zaux
dzàu	zauh
sāu	sau
sǎu	saux
sàu	sauh
kāu	kau
kǎu	kaux
kàu	kauh
khāu	khau
khǎu	khaux
khàu	khauh
ŋāu	ngau
ŋǎu	ngaux
ŋàu	ngauh
hāu	hau
hǎu	haux
hàu	hauh
ĥāu	ghau
ĥǎu	ghaux
ĥàu	ghauh
ȝāu	qau
ȝǎu	qaux
ȝàu	qauh
pā	pua
pǎ	puax
pà	puah
phā	phua
phǎ	phuax
phà	phuah
bā	bua
bǎ	buax
bà	buah
mā	mua
mǎ	muax
mà	muah
tā	ta
tǎ	tax
tà	tah
thā	tha
thǎ	thax
thà	thah
dā	da
dǎ	dax
dà	dah
nā	na
nǎ	nax
nà	nah
lā	la
lǎ	lax
là	lah
tsǎ	cax
tsà	cah
tshā	cha
tshǎ	chax
tshà	chah
dzā	za
sā	sa
sǎ	sax
sà	sah
kā	ka
kǎ	kax
kà	kah
khā	kha
khǎ	khax
khà	khah
ŋā	nga
ŋǎ	ngax
ŋà	ngah
hā	ha
hǎ	hax
hà	hah
ĥā	gha
ĥǎ	ghax
ĥà	ghah
ȝā	qa
ȝǎ	qax
ȝà	qah
tuā	tua
tuǎ	tuax
tuà	tuah
thuā	thua
thuǎ	thuax
thuà	thuah
duā	dua
duǎ	duax
duà	duah
nuā	nua
nuǎ	nuax
nuà	nuah
luā	lua
luǎ	luax
luà	luah
tsuà	cuah
tshuā	chua
tshuǎ	chuax
tshuà	chuah
dzuā	zua
dzuǎ	zuax
dzuà	zuah
suā	sua
suǎ	suax
suà	suah
kuā	kua
kuǎ	kuax
kuà	kuah
khuā	khua
khuǎ	khuax
khuà	khuah
ŋuā	ngua
ŋuǎ	nguax
ŋuà	nguah
huǎ	huax
huà	huah
ĥuā	ghua
ĥuǎ	ghuax
ĥuà	ghuah
ȝuā	qua
ȝuǎ	quax
ȝuà	quah
kiā	kia
khiā	khia
giā	gia
lüā	lya
tsüā	cya
tshüā	chya
khüā	khya
güā	gya
hüā	hya
ȝüā	qya
pǣ	pra
pæ̌	prax
pæ̀	prah
phǣ	phra
phæ̀	phrah
bǣ	bra
bæ̌	brax
bæ̀	brah
mǣ	mra
mæ̌	mrax
mæ̀	mrah
læ̌	lrax
ṭǣ	tra
ṭæ̌	trax
ṭæ̀	trah
ṭhǣ	thra
ṭhæ̌	thrax
ṭhæ̀	thrah
ḍǣ	dra
ḍæ̀	drah
ṇǣ	nra
ṇæ̌	nrax
ṇæ̀	nrah
tšǣ	cra
tšæ̌	crax
tšæ̀	crah
tšhǣ	chra
džǣ	zra
džæ̌	zrax
džæ̀	zrah
šǣ	sra
šæ̌	srax
šæ̀	srah
kǣ	kra
kæ̌	krax
kæ̀	krah
khǣ	khra
khæ̌	khrax
khæ̀	khrah
ŋǣ	ngra
ŋæ̌	ngrax
ŋæ̀	ngrah
hǣ	hra
hæ̌	hrax
hæ̀	hrah
ĥǣ	ghra
ĥæ̌	ghrax
ĥæ̀	ghrah
ȝǣ	qra
ȝæ̌	qrax
ȝæ̀	qrah
ṭuǣ	trua
ṭhuæ̌	thruax
tšuǣ	crua
tšuæ̌	cruax
tšhuæ̌	chruax
šuæ̌	sruax
šuæ̀	sruah
kuǣ	krua
kuæ̌	kruax
kuæ̀	kruah
khuǣ	khrua
khuæ̌	khruax
khuæ̀	khruah
ŋuǣ	ngrua
ŋuæ̌	ngruax
ŋuæ̀	ngruah
huǣ	hrua
huæ̀	hruah
ĥuǣ	ghrua
ĥuæ̌	ghruax
ĥuæ̀	ghruah
ȝuǣ	qrua
ȝuæ̀	qruah
miæ̌	miax
ṭiǣ	tria
tsiǣ	cia
tsiæ̌	ciax
tsiæ̀	ciah
tshiæ̌	chiax
tshiæ̀	chiah
dziǣ	zia
dziæ̀	ziah
siǣ	sia
siæ̌	siax
siæ̀	siah
ziǣ	zsia
ziæ̌	zsiax
ziæ̀	zsiah
tśiǣ	cja
tśiæ̌	cjax
tśiæ̀	cjah
tśhiǣ	chja
tśhiæ̌	chjax
tśhiæ̀	chjah
dźiǣ	zja
dźiæ̌	zjax
ńiǣ	nja
ńiæ̌	njax
śiǣ	sja
śiæ̌	sjax
śiæ̀	sjah
źiǣ	zsja
źiæ̀	zsjah
jiǣ	ja
jiæ̌	jax
jiæ̀	jah
liāŋ	liang
liǎŋ	liangx
liàŋ	liangh
lia̍k	liak
ṭiāŋ	triang
ṭiǎŋ	triangx
ṭiàŋ	triangh
ṭia̍k	triak
ṭhiāŋ	thriang
ṭhiǎŋ	thriangx
ṭhiàŋ	thriangh
ṭhia̍k	thriak
ḍiāŋ	driang
ḍiǎŋ	driangx
ḍiàŋ	driangh
ḍia̍k	driak
ṇiāŋ	nriang
ṇiàŋ	nriangh
ṇia̍k	nriak
tsiāŋ	ciang
tsiǎŋ	ciangx
tsiàŋ	ciangh
tsia̍k	ciak
tshiāŋ	chiang
tshiǎŋ	chiangx
tshiàŋ	chiangh
tshia̍k	chiak
dziāŋ	ziang
dziàŋ	ziangh
dzia̍k	ziak
siāŋ	siang
siǎŋ	siangx
siàŋ	siangh
sia̍k	siak
ziāŋ	zsiang
ziǎŋ	zsiangx
tšiāŋ	criang
tšiàŋ	criangh
tšia̍k	criak
tšhiāŋ	chriang
tšhiǎŋ	chriangx
tšhiàŋ	chriangh
džiāŋ	zriang
džiàŋ	zriangh
šiāŋ	sriang
šiǎŋ	sriangx
tśiāŋ	cjang
tśiǎŋ	cjangx
tśiàŋ	cjangh
tśia̍k	cjak
tśhiāŋ	chjang
tśhiǎŋ	chjangx
tśhiàŋ	chjangh
tśhia̍k	chjak
dźiāŋ	zjang
dźiǎŋ	zjangx
dźiàŋ	zjangh
dźia̍k	zjak
ńiāŋ	njang
ńiǎŋ	njangx
ńiàŋ	njangh
ńia̍k	njak
śiāŋ	sjang
śiǎŋ	sjangx
śiàŋ	sjangh
śia̍k	sjak
kiāŋ	kiang
kiǎŋ	kiangx
kiàŋ	kiangh
kia̍k	kiak
khiāŋ	khiang
khiàŋ	khiangh
khia̍k	khiak
giāŋ	giang
giǎŋ	giangx
giàŋ	giangh
gia̍k	giak
ŋiǎŋ	ngiangx
ŋiàŋ	ngiangh
ŋia̍k	ngiak
hiāŋ	hiang
hiǎŋ	hiangx
hiàŋ	hiangh
hia̍k	hiak
ȝiāŋ	qiang
ȝiǎŋ	qiangx
ȝiàŋ	qiangh
ȝia̍k	qiak
jiāŋ	jang
jiǎŋ	jangx
jiàŋ	jangh
jia̍k	jak
püāŋ	pyang
püǎŋ	pyangx
püàŋ	pyangh
phüāŋ	phyang
phüǎŋ	phyangx
phüàŋ	phyangh
phüa̍k	phyak
büāŋ	byang
büǎŋ	byangx
büàŋ	byangh
büa̍k	byak
müāŋ	myang
müǎŋ	myangx
müàŋ	myangh
küǎŋ	kyangx
küàŋ	kyangh
küa̍k	kyak
khüāŋ	khyang
khüa̍k	khyak
güāŋ	gyang
güǎŋ	gyangx
güàŋ	gyangh
güa̍k	gyak
hüǎŋ	hyangx
hüàŋ	hyangh
hüa̍k	hyak
ȝüǎŋ	qyangx
ȝüa̍k	qyak
üāŋ	yang
üǎŋ	yangx
üàŋ	yangh
üa̍k	yak
pāŋ	pang
pǎŋ	pangx
pàŋ	pangh
pa̍k	pak
phāŋ	phang
phǎŋ	phangx
pha̍k	phak
bāŋ	bang
bàŋ	bangh
ba̍k	bak
māŋ	mang
mǎŋ	mangx
màŋ	mangh
ma̍k	mak
tāŋ	tang
tǎŋ	tangx
tàŋ	tangh
thāŋ	thang
thǎŋ	thangx
thàŋ	thangh
tha̍k	thak
dāŋ	dang
dǎŋ	dangx
dàŋ	dangh
da̍k	dak
nāŋ	nang
nǎŋ	nangx
nàŋ	nangh
na̍k	nak
lāŋ	lang
lǎŋ	langx
làŋ	langh
la̍k	lak
tsāŋ	cang
tsǎŋ	cangx
tsàŋ	cangh
tsa̍k	cak
tshāŋ	chang
tshǎŋ	changx
tsha̍k	chak
dzāŋ	zang
dzǎŋ	zangx
dzàŋ	zangh
dza̍k	zak
sāŋ	sang
sǎŋ	sangx
sàŋ	sangh
sa̍k	sak
kāŋ	kang
kǎŋ	kangx
kàŋ	kangh
ka̍k	kak
khāŋ	khang
khǎŋ	khangx
khàŋ	khangh
kha̍k	khak
ŋāŋ	ngang
ŋǎŋ	ngangx
ŋàŋ	ngangh
ŋa̍k	ngak
hāŋ	hang
hǎŋ	hangx
ha̍k	hak
ĥāŋ	ghang
ĥǎŋ	ghangx
ĥàŋ	ghangh
ĥa̍k	ghak
ȝāŋ	qang
ȝǎŋ	qangx
ȝàŋ	qangh
ȝa̍k	qak
lua̍k	luak
tsua̍k	cuak
kuāŋ	kuang
kuǎŋ	kuangx
kuàŋ	kuangh
kua̍k	kuak
khuāŋ	khuang
khuǎŋ	khuangx
khuàŋ	khuangh
khua̍k	khuak
ŋua̍k	nguak
huāŋ	huang
huǎŋ	huangx
huàŋ	huangh
hua̍k	huak
ĥuāŋ	ghuang
ĥuǎŋ	ghuangx
ĥuàŋ	ghuangh
ĥua̍k	ghuak
ȝuāŋ	quang
ȝuǎŋ	quangx
ȝuàŋ	quangh
ȝua̍k	quak
pǣŋ	prang
pæ̌ŋ	prangx
pæ̀ŋ	prangh
pæ̍k	prak
phǣŋ	phrang
phæ̍k	phrak
bǣŋ	brang
bæ̌ŋ	brangx
bæ̀ŋ	brangh
bæ̍k	brak
mǣŋ	mrang
mæ̌ŋ	mrangx
mæ̀ŋ	mrangh
mæ̍k	mrak
læ̌ŋ	lrangx
ṭǣŋ	trang
ṭæ̌ŋ	trangx
ṭæ̀ŋ	trangh
ṭæ̍k	trak
ṭhǣŋ	thrang
ṭhæ̀ŋ	thrangh
ṭhæ̍k	thrak
ḍǣŋ	drang
ḍæ̌ŋ	drangx
ḍæ̀ŋ	drangh
ḍæ̍k	drak
ṇǣŋ	nrang
ṇæ̌ŋ	nrangx
ṇæ̍k	nrak
tšæ̍k	crak
tšhǣŋ	chrang
džǣŋ	zrang
džæ̍k	zrak
šǣŋ	srang
kǣŋ	krang
kæ̌ŋ	krangx
kæ̀ŋ	krangh
kæ̍k	krak
khǣŋ	khrang
khæ̍k	khrak
ŋæ̍k	ngrak
hǣŋ	hrang
hæ̀ŋ	hrangh
hæ̍k	hrak
ĥǣŋ	ghrang
ĥæ̌ŋ	ghrangx
ĥæ̀ŋ	ghrangh
ĥæ̍k	ghrak
ȝæ̀ŋ	qrangh
ȝæ̍k	qrak
kuǣŋ	kruang
kuæ̌ŋ	kruangx
kuæ̍k	kruak
khuæ̌ŋ	khruangx
khuæ̍k	khruak
huǣŋ	hruang
huæ̍k	hruak
ĥuǣŋ	ghruang
ĥuæ̌ŋ	ghruangx
ĥuæ̀ŋ	ghruangh
ĥuæ̍k	ghruak
ȝuæ̌ŋ	qruangx
ȝuæ̀ŋ	qruangh
ȝuæ̍k	qruak
piǣŋ	pieng
piæ̌ŋ	piengx
piæ̀ŋ	piengh
biǣŋ	bieng
biæ̀ŋ	biengh
biæ̍k	biek
miǣŋ	mieng
miæ̌ŋ	miengx
miæ̀ŋ	miengh
tšhiæ̀ŋ	chriengh
tšhiæ̍k	chriek
šiæ̌ŋ	sriengx
šiæ̀ŋ	sriengh
šiæ̍k	sriek
kiǣŋ	kieng
kiæ̌ŋ	kiengx
kiæ̀ŋ	kiengh
kiæ̍k	kiek
khiǣŋ	khieng
khiæ̀ŋ	khiengh
khiæ̍k	khiek
giǣŋ	gieng
giæ̀ŋ	giengh
giæ̍k	giek
ŋiǣŋ	ngieng
ŋiæ̀ŋ	ngiengh
ŋiæ̍k	ngiek
hiæ̍k	hiek
ȝiǣŋ	qieng
ȝiæ̌ŋ	qiengx
ȝiæ̀ŋ	qiengh
küæ̌ŋ	kyengx
hüǣŋ	hyeng
hüæ̌ŋ	hyengx
üǣŋ	yeng
üæ̌ŋ	yengx
üæ̀ŋ	yengh
pɛ̄ŋ	preng
pɛ̀ŋ	prengh
pɛ̍k	prek
phɛ̄ŋ	phreng
phɛ̌ŋ	phrengx
phɛ̍k	phrek
bɛ̄ŋ	breng
bɛ̌ŋ	brengx
bɛ̀ŋ	brengh
bɛ̍k	brek
mɛ̄ŋ	mreng
mɛ̌ŋ	mrengx
mɛ̍k	mrek
lɛ̍k	lrek
ṭɛ̄ŋ	treng
ṭɛ̍k	trek
ḍɛ̄ŋ	dreng
ṇɛ̄ŋ	nreng
ṇɛ̍k	nrek
tšɛ̄ŋ	creng
tšɛ̀ŋ	crengh
tšɛ̍k	crek
tšhɛ̄ŋ	chreng
tšhɛ̍k	chrek
džɛ̄ŋ	zreng
džɛ̍k	zrek
šɛ̍k	srek
kɛ̄ŋ	kreng
kɛ̌ŋ	krengx
kɛ̍k	krek
khɛ̄ŋ	khreng
khɛ̍k	khrek
ŋɛ̄ŋ	ngreng
ŋɛ̀ŋ	ngrengh
ŋɛ̍k	ngrek
ĥɛ̄ŋ	ghreng
ĥɛ̌ŋ	ghrengx
ĥɛ̍k	ghrek
ȝɛ̄ŋ	qreng
ȝɛ̀ŋ	qrengh
ȝɛ̍k	qrek
tšuɛ̍k	cruek
džuɛ̍k	zruek
šuɛ̍k	sruek
kuɛ̍k	kruek
guɛ̍k	gruek
huɛ̄ŋ	hrueng
huɛ̀ŋ	hruengh
huɛ̍k	hruek
ĥuɛ̄ŋ	ghrueng
ĥuɛ̍k	ghruek
ȝuɛ̄ŋ	qrueng
pьiēŋ	pjeng
pьiěŋ	pjengx
pьièŋ	pjengh
pьie̍k	pjek
phьièŋ	phjengh
phьie̍k	phjek
bьièŋ	bjengh
bьie̍k	bjek
mьiēŋ	mjeng
mьiěŋ	mjengx
mьièŋ	mjengh
lьiēŋ	lieng
lьiěŋ	liengx
lьièŋ	liengh
tsьiēŋ	cieng
tsьiěŋ	ciengx
tsьièŋ	ciengh
tsьie̍k	ciek
tshьiēŋ	chieng
tshьiěŋ	chiengx
tshьièŋ	chiengh
tshьie̍k	chiek
dzьiēŋ	zieng
dzьiěŋ	ziengx
dzьièŋ	ziengh
dzьie̍k	ziek
sьiěŋ	siengx
sьièŋ	siengh
sьie̍k	siek
zьiēŋ	zsieng
zьie̍k	zsiek
tśьiēŋ	cjeng
tśьiěŋ	cjengx
tśьièŋ	cjengh
tśьie̍k	cjek
tśhьie̍k	chjek
dźьiēŋ	zjeng
dźьièŋ	zjengh
dźьie̍k	zjek
śьiēŋ	sjeng
śьièŋ	sjengh
śьie̍k	sjek
źьie̍k	zsjek
kьiěŋ	kjengx
kьièŋ	kjengh
khьiēŋ	khjeng
khьièŋ	khjengh
gьiēŋ	gjeng
gьiěŋ	gjengx
hьièŋ	hjengh
ȝьiēŋ	qjeng
ȝьiěŋ	qjengx
ȝьie̍k	qjek
jьiēŋ	jeng
jьiěŋ	jengx
jьie̍k	jek
tshьüe̍k	chyek
sьüēŋ	syeng
tśьüe̍k	cjyek
khьüēŋ	khjyeng
khьüěŋ	khjyengx
gьüēŋ	gjyeng
hьüēŋ	hjyeng
hьüèŋ	hjyengh
hьüe̍k	hjyek
ȝьüēŋ	qjyeng
jьüēŋ	jyeng
jьüěŋ	jyengx
jьüe̍k	jyek
pie̍k	piek
ṭiēŋ	trieng
ṭie̍k	triek
ṭhiēŋ	thrieng
ṭhiěŋ	thriengx
ṭhièŋ	thriengh
ṭhie̍k	thriek
ḍiēŋ	drieng
ḍiěŋ	driengx
ḍièŋ	driengh
ḍie̍k	driek
pěŋ	pengx
pe̍k	pek
phēŋ	pheng
phěŋ	phengx
phe̍k	phek
bēŋ	beng
běŋ	bengx
be̍k	bek
mēŋ	meng
měŋ	mengx
mèŋ	mengh
me̍k	mek
tēŋ	teng
těŋ	tengx
tèŋ	tengh
te̍k	tek
thēŋ	theng
thěŋ	thengx
thèŋ	thengh
the̍k	thek
dēŋ	deng
děŋ	dengx
dèŋ	dengh
de̍k	dek
nēŋ	neng
něŋ	nengx
nèŋ	nengh
ne̍k	nek
lēŋ	leng
lěŋ	lengx
lèŋ	lengh
le̍k	lek
tse̍k	cek
tshēŋ	cheng
tshèŋ	chengh
tshe̍k	chek
dzěŋ	zengx
dze̍k	zek
sēŋ	seng
sěŋ	sengx
sèŋ	sengh
se̍k	sek
kēŋ	keng
kěŋ	kengx
kèŋ	kengh
ke̍k	kek
khěŋ	khengx
khèŋ	khengh
khe̍k	khek
ŋěŋ	ngengx
ŋe̍k	ngek
hēŋ	heng
he̍k	hek
ĥēŋ	gheng
ĥěŋ	ghengx
ĥèŋ	ghengh
ĥe̍k	ghek
ȝěŋ	qengx
ȝèŋ	qengh
kuēŋ	kueng
kuěŋ	kuengx
kue̍k	kuek
khuěŋ	khuengx
khue̍k	khuek
huěŋ	huengx
hue̍k	huek
ĥuēŋ	ghueng
ĥuěŋ	ghuengx
ȝuěŋ	quengx
pīŋ	ping
pi̍k	pik
phīŋ	phing
phi̍k	phik
bīŋ	bing
bìŋ	bingh
bi̍k	bik
mi̍k	mik
līŋ	ling
lìŋ	lingh
li̍k	lik
ṭīŋ	tring
ṭi̍k	trik
ṭhīŋ	thring
ṭhǐŋ	thringx
ṭhìŋ	thringh
ṭhi̍k	thrik
ḍīŋ	dring
ḍìŋ	dringh
ḍi̍k	drik
ṇi̍k	nrik
tsìŋ	cingh
tsi̍k	cik
dzīŋ	zing
dzi̍k	zik
si̍k	sik
tši̍k	crik
tšhi̍k	chrik
džīŋ	zring
dži̍k	zrik
šīŋ	sring
šǐŋ	sringx
ši̍k	srik
tśīŋ	cjing
tśǐŋ	cjingx
tśìŋ	cjingh
tśi̍k	cjik
tśhīŋ	chjing
tśhìŋ	chjingh
tśhi̍k	chjik
dźīŋ	zjing
dźìŋ	zjingh
dźi̍k	zjik
ńīŋ	njing
ńìŋ	njingh
śīŋ	sjing
śìŋ	sjingh
śi̍k	sjik
źīŋ	zsjing
źìŋ	zsjingh
źi̍k	zsjik
kīŋ	king
ki̍k	kik
khīŋ	khing
khi̍k	khik
gīŋ	ging
gǐŋ	gingx
gìŋ	gingh
gi̍k	gik
ŋīŋ	nging
ŋìŋ	ngingh
ŋi̍k	ngik
hīŋ	hing
hìŋ	hingh
hi̍k	hik
ȝīŋ	qing
ȝìŋ	qingh
ȝi̍k	qik
jīŋ	jing
jìŋ	jingh
ji̍k	jik
hüi̍k	hyk
üi̍k	yk
pə̄ŋ	pong
pə̀ŋ	pongh
pə̍k	pok
phə̄ŋ	phong
phə̌ŋ	phongx
phə̍k	phok
bə̄ŋ	bong
bə̀ŋ	bongh
bə̍k	bok
mə̄ŋ	mong
mə̀ŋ	mongh
mə̍k	mok
tə̄ŋ	tong
tə̌ŋ	tongx
tə̀ŋ	tongh
tə̍k	tok
thə̄ŋ	thong
thə̀ŋ	thongh
thə̍k	thok
də̄ŋ	dong
də̀ŋ	dongh
də̍k	dok
nə̄ŋ	nong
nə̌ŋ	nongx
nə̍k	nok
lə̄ŋ	long
lə̀ŋ	longh
lə̍k	lok
tsə̄ŋ	cong
tsə̀ŋ	congh
tsə̍k	cok
tshə̀ŋ	chongh
tshə̍k	chok
dzə̄ŋ	zong
dzə̀ŋ	zongh
dzə̍k	zok
sə̄ŋ	song
sə̀ŋ	songh
sə̍k	sok
kə̄ŋ	kong
kə̀ŋ	kongh
kə̍k	kok
khə̌ŋ	khongx
khə̍k	khok
hə̍k	hok
ĥə̄ŋ	ghong
ĥə̍k	ghok
ȝə̍k	qok
kuə̄ŋ	kuong
kuə̍k	kuok
huə̄ŋ	huong
huə̍k	huok
ĥuə̄ŋ	ghuong
ĥuə̍k	ghuok
liə̄u	liu
liə̌u	liux
liə̀u	liuh
ṭiə̄u	triu
ṭiə̌u	triux
ṭiə̀u	triuh
ṭhiə̄u	thriu
ṭhiə̌u	thriux
ṭhiə̀u	thriuh
ḍiə̄u	driu
ḍiə̌u	driux
ḍiə̀u	driuh
ṇiə̌u	nriux
ṇiə̀u	nriuh
tsiə̄u	ciu
tsiə̌u	ciux
tsiə̀u	ciuh
tshiə̄u	chiu
tshiə̀u	chiuh
dziə̄u	ziu
dziə̌u	ziux
dziə̀u	ziuh
siə̄u	siu
siə̌u	siux
siə̀u	siuh
ziə̄u	zsiu
ziə̀u	zsiuh
tšiə̄u	criu
tšiə̌u	criux
tšiə̀u	criuh
tšhiə̄u	chriu
tšhiə̌u	chriux
tšhiə̀u	chriuh
džiə̄u	zriu
džiə̌u	zriux
džiə̀u	zriuh
šiə̄u	sriu
šiə̌u	sriux
šiə̀u	sriuh
tśiə̄u	cju
tśiə̌u	cjux
tśiə̀u	cjuh
tśhiə̄u	chju
tśhiə̌u	chjux
tśhiə̀u	chjuh
dźiə̄u	zju
dźiə̌u	zjux
dźiə̀u	zjuh
ńiə̄u	nju
ńiə̌u	njux
ńiə̀u	njuh
śiə̄u	sju
śiə̌u	sjux
śiə̀u	sjuh
kiə̄u	kiu
kiə̌u	kiux
kiə̀u	kiuh
khiə̄u	khiu
khiə̌u	khiux
khiə̀u	khiuh
giə̄u	giu
giə̌u	giux
giə̀u	giuh
ŋiə̄u	ngiu
ŋiə̀u	ngiuh
hiə̄u	hiu
hiə̌u	hiux
hiə̀u	hiuh
ȝiə̄u	qiu
ȝiə̌u	qiux
jiə̄u	ju
jiə̌u	jux
jiə̀u	juh
iə̄u	iu
iə̌u	iux
iə̀u	iuh
püə̄u	piu
püə̌u	piux
püə̀u	piuh
phüə̄u	phiu
phüə̌u	phiux
phüə̀u	phiuh
büə̄u	biu
büə̌u	biux
büə̀u	biuh
müə̄u	miu
müə̀u	miuh
pə̌u	pux
phə̌u	phux
phə̀u	phuh
bə̄u	bu
bə̌u	bux
bə̀u	buh
mə̄u	mu
mə̌u	mux
mə̀u	muh
tə̄u	tu
tə̌u	tux
tə̀u	tuh
thə̄u	thu
thə̌u	thux
thə̀u	thuh
də̄u	du
də̌u	dux
də̀u	duh
nə̄u	nu
nə̌u	nux
nə̀u	nuh
lə̄u	lu
lə̌u	lux
lə̀u	luh
tsə̄u	cu
tsə̌u	cux
tsə̀u	cuh
tshə̄u	chu
tshə̌u	chux
tshə̀u	chuh
dzə̄u	zu
dzə̌u	zux
dzə̀u	zuh
sə̄u	su
sə̌u	sux
sə̀u	suh
kə̄u	ku
kə̌u	kux
kə̀u	kuh
khə̄u	khu
khə̌u	khux
khə̀u	khuh
ŋə̄u	ngu
ŋə̌u	ngux
ŋə̀u	nguh
hə̄u	hu
hə̌u	hux
hə̀u	huh
ĥə̄u	ghu
ĥə̌u	ghux
ĥə̀u	ghuh
ȝə̄u	qu
ȝə̌u	qux
ȝə̀u	quh
piū	py
biū	by
miū	my
miù	myh
liū	ly
tsiū	cy
šiū	sry
kiū	ky
kiǔ	kyx
khiù	khyh
giū	gy
giǔ	gyx
giù	gyh
ŋiū	ngy
hiū	hy
ȝiū	qy
ȝiǔ	qyx
ȝiù	qyh
lьīm	lim
lьǐm	limx
lьìm	limh
lьi̍p	lip
tsьīm	cim
tsьǐm	cimx
tsьìm	cimh
tsьi̍p	cip
tshьīm	chim
tshьǐm	chimx
tshьìm	chimh
tshьi̍p	chip
dzьīm	zim
dzьǐm	zimx
dzьi̍p	zip
sьīm	sim
sьǐm	simx
sьi̍p	sip
zьīm	zsim
zьi̍p	zsip
tśьīm	cjim
tśьǐm	cjimx
tśьìm	cjimh
tśьi̍p	cjip
tśhьīm	chjim
tśhьǐm	chjimx
tśhьi̍p	chjip
dźьīm	zjim
dźьǐm	zjimx
dźьìm	zjimh
dźьi̍p	zjip
ńьīm	njim
ńьǐm	njimx
ńьìm	njimh
ńьi̍p	njip
śьīm	sjim
śьǐm	sjimx
śьìm	sjimh
śьi̍p	sjip
źьǐm	zsjimx
ȝьīm	qjim
ȝьi̍p	qjip
jьīm	jim
jьǐm	jimx
jьi̍p	jip
pǐm	pimx
pi̍p	pip
phǐm	phimx
bi̍p	bip
ṭīm	trim
ṭǐm	trimx
ṭìm	trimh
ṭi̍p	trip
ṭhīm	thrim
ṭhǐm	thrimx
ṭhìm	thrimh
ṭhi̍p	thrip
ḍīm	drim
ḍǐm	drimx
ḍìm	drimh
ḍi̍p	drip
ṇīm	nrim
ṇǐm	nrimx
ṇìm	nrimh
ṇi̍p	nrip
tšīm	crim
tšìm	crimh
tši̍p	crip
tšhīm	chrim
tšhǐm	chrimx
tšhìm	chrimh
tšhi̍p	chrip
džīm	zrim
džǐm	zrimx
dži̍p	zrip
šīm	srim
šǐm	srimx
šìm	srimh
ši̍p	srip
kīm	kim
kǐm	kimx
kìm	kimh
ki̍p	kip
khīm	khim
khǐm	khimx
khi̍p	khip
gīm	gim
gǐm	gimx
gìm	gimh
gi̍p	gip
ŋīm	ngim
ŋǐm	ngimx
ŋìm	ngimh
ŋi̍p	ngip
hīm	him
hǐm	himx
hi̍p	hip
ȝīm	qim
ȝǐm	qimx
ȝìm	qimh
ȝi̍p	qip
ìm	imh
i̍p	ip
tōm	tom
tǒm	tomx
tòm	tomh
to̍p	top
thōm	thom
thǒm	thomx
thòm	thomh
tho̍p	thop
dōm	dom
dǒm	domx
dòm	domh
do̍p	dop
nōm	nom
nǒm	nomx
nòm	nomh
no̍p	nop
lōm	lom
lǒm	lomx
lòm	lomh
lo̍p	lop
tsōm	com
tsǒm	comx
tsòm	comh
tso̍p	cop
tshōm	chom
tshǒm	chomx
tshòm	chomh
tsho̍p	chop
dzōm	zom
dzǒm	zomx
dzo̍p	zop
sōm	som
sǒm	somx
sòm	somh
so̍p	sop
kōm	kom
kǒm	komx
kòm	komh
ko̍p	kop
khōm	khom
khǒm	khomx
khòm	khomh
kho̍p	khop
ŋōm	ngom
ŋǒm	ngomx
ŋòm	ngomh
ŋo̍p	ngop
hōm	hom
hǒm	homx
hòm	homh
ho̍p	hop
ĥōm	ghom
ĥǒm	ghomx
ĥòm	ghomh
ĥo̍p	ghop
ȝōm	qom
ȝǒm	qomx
ȝòm	qomh
ȝo̍p	qop
mām	mam
mǎm	mamx
tām	tam
tǎm	tamx
tàm	tamh
ta̍p	tap
thām	tham
thǎm	thamx
thàm	thamh
tha̍p	thap
dām	dam
dǎm	damx
dàm	damh
da̍p	dap
na̍p	nap
lām	lam
lǎm	lamx
làm	lamh
la̍p	lap
tsām	cam
tsǎm	camx
tshǎm	chamx
tsha̍p	chap
dzām	zam
dzǎm	zamx
dzàm	zamh
dza̍p	zap
sām	sam
sàm	samh
sa̍p	sap
kām	kam
kǎm	kamx
kàm	kamh
ka̍p	kap
khām	kham
khǎm	khamx
khàm	khamh
kha̍p	khap
ŋa̍p	ngap
hām	ham
hǎm	hamx
hàm	hamh
ha̍p	hap
ĥām	gham
ĥàm	ghamh
ĥa̍p	ghap
ȝǎm	qamx
ȝa̍p	qap
tśia̍p	cjap
śiǎm	sjamx
lьiēm	liem
lьiěm	liemx
lьièm	liemh
lьie̍p	liep
tsьiēm	ciem
tsьiěm	ciemx
tsьièm	ciemh
tsьie̍p	ciep
tshьiēm	chiem
tshьiěm	chiemx
tshьièm	chiemh
tshьie̍p	chiep
dzьiēm	ziem
dzьiěm	ziemx
dzьièm	ziemh
dzьie̍p	ziep
sьiēm	siem
zьiēm	zsiem
tśьiēm	cjem
tśьiěm	cjemx
tśьièm	cjemh
tśьie̍p	cjep
tśhьiēm	chjem
tśhьièm	chjemh
tśhьie̍p	chjep
dźьiēm	zjem
dźьiěm	zjemx
dźьièm	zjemh
dźьie̍p	zjep
ńьiēm	njem
ńьiěm	njemx
ńьièm	njemh
ńьie̍p	njep
śьiēm	sjem
śьiěm	sjemx
śьièm	sjemh
śьie̍p	sjep
khьiěm	khjemx
khьie̍p	khjep
gьiēm	gjem
ȝьiēm	qjem
ȝьiěm	qjemx
ȝьièm	qjemh
ȝьie̍p	qjep
jьiēm	jem
jьiěm	jemx
jьièm	jemh
jьie̍p	jep
piēm	piem
piěm	piemx
pièm	piemh
ṭiēm	triem
ṭie̍p	triep
ṭhiēm	thriem
ṭhiěm	thriemx
ṭhièm	thriemh
ṭhie̍p	thriep
ḍiēm	driem
ḍie̍p	driep
ṇiēm	nriem
ṇie̍p	nriep
šiēm	sriem
šie̍p	sriep
kiěm	kiemx
kie̍p	kiep
khiēm	khiem
khiěm	khiemx
giēm	giem
giěm	giemx
gie̍p	giep
ŋiēm	ngiem
ŋiěm	ngiemx
ŋièm	ngiemh
hiěm	hiemx
ȝiēm	qiem
ȝiěm	qiemx
ȝièm	qiemh
ȝie̍p	qiep
iēm	iem
ie̍p	iep
měm	memx
tēm	tem
těm	temx
tèm	temh
te̍p	tep
thēm	them
thěm	themx
thèm	themh
the̍p	thep
dēm	dem
děm	demx
dèm	demh
de̍p	dep
nēm	nem
něm	nemx
nèm	nemh
ne̍p	nep
lēm	lem
lěm	lemx
lèm	lemh
le̍p	lep
tsèm	cemh
tse̍p	cep
tshěm	chemx
dzèm	zemh
dze̍p	zep
sèm	semh
se̍p	sep
kēm	kem
kěm	kemx
kèm	kemh
ke̍p	kep
khēm	khem
khěm	khemx
khèm	khemh
khe̍p	khep
hēm	hem
he̍p	hep
ĥēm	ghem
ĥěm	ghemx
ĥe̍p	ghep
ȝèm	qemh
lɛ̌m	lremx
ṭɛ̄m	trem
ṭɛ̀m	tremh
ṭɛ̍p	trep
ṭhɛ̌m	thremx
ṭhɛ̍p	threp
ḍɛ̌m	dremx
ḍɛ̀m	dremh
ṇɛ̄m	nrem
ṇɛ̌m	nremx
ṇɛ̀m	nremh
ṇɛ̍p	nrep
tšɛ̌m	cremx
tšɛ̀m	cremh
tšɛ̍p	crep
tšhɛ̌m	chremx
tšhɛ̍p	chrep
džɛ̄m	zrem
džɛ̌m	zremx
džɛ̀m	zremh
džɛ̍p	zrep
šɛ̄m	srem
šɛ̌m	sremx
šɛ̍p	srep
kɛ̄m	krem
kɛ̌m	kremx
kɛ̀m	kremh
kɛ̍p	krep
khɛ̄m	khrem
khɛ̌m	khremx
khɛ̀m	khremh
khɛ̍p	khrep
ŋɛ̄m	ngrem
ŋɛ̀m	ngremh
ŋɛ̍p	ngrep
hɛ̄m	hrem
hɛ̌m	hremx
hɛ̍p	hrep
ĥɛ̄m	ghrem
ĥɛ̌m	ghremx
ĥɛ̀m	ghremh
ĥɛ̍p	ghrep
ȝɛ̄m	qrem
ȝɛ̌m	qremx
ȝɛ̀m	qremh
ȝɛ̍p	qrep
bǣm	bram
bæ̀m	bramh
ḍæ̍p	drap
tšæ̀m	cramh
tšhǣm	chram
tšhæ̌m	chramx
tšhæ̀m	chramh
džǣm	zram
džæ̌m	zramx
džæ̀m	zramh
šǣm	sram
šæ̌m	sramx
šæ̀m	sramh
šæ̍p	srap
kǣm	kram
kæ̀m	kramh
kæ̍p	krap
khǣm	khram
khæ̌m	khramx
ŋǣm	ngram
hæ̌m	hramx
hæ̀m	hramh
hæ̍p	hrap
ĥǣm	ghram
ĥæ̌m	ghramx
ĥæ̀m	ghramh
ĥæ̍p	ghrap
ȝæ̌m	qramx
ȝæ̀m	qramh
ȝæ̍p	qrap
ṭhiæ̌m	thriamx
ṭhiæ̍p	thriap
ṇiæ̍p	nriap
kiæ̀m	kiamh
kiæ̍p	kiap
khiǣm	khiam
khiæ̌m	khiamx
khiæ̀m	khiamh
khiæ̍p	khiap
giæ̍p	giap
ŋiǣm	ngiam
ŋiæ̌m	ngiamx
ŋiæ̀m	ngiamh
ŋiæ̍p	ngiap
hiǣm	hiam
hiæ̀m	hiamh
hiæ̍p	hiap
ȝiǣm	qiam
ȝiæ̌m	qiamx
ȝiæ̀m	qiamh
ȝiæ̍p	qiap
jiæ̍p	jap
püǒm	pyamx
püo̍p	pyap
phüōm	phyam
phüǒm	phyamx
phüòm	phyamh
phüo̍p	phyap
büōm	byam
büǒm	byamx
büòm	byamh
büo̍p	byap
müǒm	myamx
müòm	myamh